WSWWWWWWWW
WPPPPPPPBW
WBWBWWWPWW
WBBBWPPPBW
WWWWWPWWWW
WBBBWPWBBW
WBWWWPWBWW
WBBBBPPPBW
WBWBWBWPWW
WWWWWWWEWW
