BBBBBBWBBWBBWBBBBBBB
BBBBBBBWBWBWBBBBBBBB
BBBBBBBBBBBBBBBBBBBB
BBBBBBBBWWWBBBBBBBBB
BBBBBBBWBWBWBBBBBBBB
BBBBBBWBBBBBWBBBBBBB
BBBBBBWBBBBBWBBBBBBB
BBBBBBBWBBBWBBBBBBBB
BBBBBBBWBBBWBBBBBBBB
BBBBBBBWBBBWBBBBBBBB
BBBBBBBWBBBWBBBBBBBB
BBBBBBBWBBBWBBBBBBBB
BBBBBBBWBBBWBBBBBBBB
BBBBBBBWBBBWBBBBBBBB
BBBBBBBWBBBWBBBBBBBB
BBBWWWBWBBBWBWWWBBBB
BBWBBBWWBBBWWBBBWBBB
BWBBBBBWBBBWBBBBBWBB
BWBBBBBWBBBWBBBBBWBB
BWBBBBBBBBBBBBBBBWBB
